username	position
Halie Rando	post-doc
Casey Greene	faculty (sr)
Michael Robson	faculty (jr)
Ronnie Russell	grad student
Christian Brueffer	grad student
Nils Wellhausen	grad student
Ronan Lordan	post-doc
Sandipan Ray	faculty (jr)
Anna Ada Dattoli	post-doc
Anthony Gitter	faculty (jr)
Lucy D'Agostino McGowan	faculty (jr)
Jeff Field	faculty (sr)
Adam MacLean	faculty (jr)
Alexandra Lee	phd student
Fengling Hu	md/phd student
Diane Rafizadeh	md/phd student
John J. Dziak	faculty (jr)
Elizabeth Sell	med student
Jinhui Wang	staff
Marouen Ben Guebila	post-doc
Ashwin N Skelly	md/phd student
David Mai	phd student
Likhitha Kolla	md/phd student
Yoson Park	post-doc
Daniel Himmelstein	post-doc
J. Brian Byrd	faculty (jr)
Soumita Ghosh	staff
David Manheim	staff
Yael Marshall	other
Ryan Velazquez	other
Simina M. Boca	faculty (sr)
Vikas Bansal	faculty (jr)
Vincent Rubinetti	staff
Lamonica Shinholster	undergrad student
Sergey Knyazev	phd student
Dimitri Perrin	faculty (sr)
Temitayo Lukan	undergrad student
Greg Szeto	other
Tiago Lubiana	phd student
Amruta Naik	post-doc
Yusha Sun	md/phd student
